2433,2433,2433,2433,2433,2433,2433,2433,2433,2433,2433,2433,2433,2433,2433,2433,2433,2433,2433,2433,2433,2433,2433,2433,2433,2441,2441,2441,2441,2441,2441,2441,2441,2441,2441,2441,2441,2441,2441,2441,2441,2441,2433,2433,2433,2433,2433,2433,2433,2433,2433,2433,2433,2433,2433,2433,2433,2433,2433,2433,2433,2433,2433,2433
2441,2441,2441,2441,2441,2441,2441,2441,2441,2441,2441,2441,2441,2441,2441,2441,2441,2441,2441,2441,2441,2441,2441,2441,2441,2441,2441,2441,2441,2441,2441,2441,2441,2441,2441,2441,2441,2441,2441,2441,2441,2441,2433,2433,2433,2433,2433,2433,2433,2433,2433,2433,2433,2433,2433,2433,2433,2433,2433,2433,2433,2433,2433,2433
2433,2433,2433,2433,2433,2433,2433,2433,2433,2433,2433,2433,2433,2433,2433,2433,2433,2433,2433,2433,2433,2433,2433,2433,2433,2441,2441,2441,2441,2441,2441,2441,2441,2441,2441,2441,2441,2441,2441,2441,2441,2441,2433,2433,2433,2433,2433,2433,2433,2433,2433,2433,2433,2433,2433,2433,2433,2433,2433,2433,2433,2433,2433,2433
2433,2433,2433,2433,2433,2433,2433,2433,2433,2433,2433,2433,2433,2433,2433,2433,2433,2433,2433,2433,2433,2433,2433,2433,2433,2441,2441,2441,2441,2441,2441,2441,2441,2441,2441,2441,2441,2441,2441,2441,2441,2441,2433,2433,2433,2433,2433,2433,2433,2433,2433,2433,2433,2433,2433,2433,2433,2433,2433,2433,2433,2433,2433,2433
2433,2433,2433,2433,2433,2433,2433,2433,2433,2433,2433,2433,2433,2433,2433,2433,2433,2433,2433,2433,2433,2433,2433,2433,2433,2441,2441,2441,2441,2441,2441,2433,2433,2433,2433,2433,2433,2433,2433,2433,2433,2433,2433,2433,2433,2433,2433,2433,2433,2433,2433,2433,2433,2433,2433,2433,2433,2433,2433,2433,2433,2433,2433,2433
2433,2433,2433,2433,2433,2433,2433,2433,2433,2433,2433,2433,2433,2433,2433,2433,2433,2433,2433,2433,2433,2433,2433,2433,2433,2441,2441,2433,2433,2433,2433,2441,2441,2441,2441,2441,2441,2433,2433,2441,2441,2441,2441,2441,2433,2433,2433,2433,2433,2433,2433,2433,2433,2433,2433,2433,2433,2433,2433,2433,2433,2433,2433,2433
2433,2433,2433,2433,2433,2433,2433,2433,2433,2433,2433,2433,2433,2433,2433,2433,2433,2433,2433,2433,2433,2433,2433,2433,2433,2433,2433,2441,2441,2441,2441,2441,2441,2441,2441,2441,2441,2441,2441,2441,2441,2441,2441,2441,2433,2433,2433,2433,2433,2433,2433,2433,2433,2433,2433,2433,2433,2433,2433,2433,2433,2433,2433,2433
2433,2433,2433,2433,2433,2433,2433,2433,2433,2433,2433,2433,2433,2433,2433,2433,2433,2433,2433,2433,2433,2433,2433,2433,2441,2441,2441,2441,2441,2441,2441,2441,2441,2441,2441,2441,2433,2441,2441,2441,2441,2441,2441,2441,2433,2433,2433,2433,2433,2433,2433,2433,2433,2433,2433,2433,2433,2433,2433,2433,2433,2433,2433,2433
2433,2433,2433,2433,2433,2433,2433,2433,2433,2433,2433,2433,2433,2433,2433,2433,2433,2433,2433,2433,2433,2433,2441,2441,2441,2441,2441,2441,2441,2441,2441,2441,2441,2441,2441,2433,2441,2441,2441,2441,2441,2441,2441,2441,2433,2433,2433,2433,2433,2433,2433,2433,2433,2433,2433,2433,2433,2433,2433,2433,2433,2433,2433,2433
2433,2433,2433,2433,2433,2433,2433,2433,2433,2433,2433,2433,2433,2433,2433,2433,2433,2433,2433,2433,2433,2441,2441,2441,2441,2441,2441,2441,2441,2441,2441,2441,2441,2441,2433,2441,2441,2441,2441,2441,2441,2441,2441,2441,2433,2433,2433,2433,2433,2433,2433,2433,2433,2433,2433,2433,2433,2433,2433,2433,2433,2433,2433,2433
2433,2433,2433,2433,2433,2433,2433,2433,2433,2433,2433,2433,2433,2433,2433,2433,2433,2433,2433,2433,2441,2441,2441,2441,2441,2441,2441,2441,2441,2441,2441,2441,2441,2433,2441,2441,2441,2441,2441,2441,2441,2441,2441,2441,2433,2433,2433,2433,2433,2433,2433,2433,2433,2433,2433,2433,2433,2433,2433,2433,2433,2433,2433,2433
2433,2433,2433,2433,2433,2433,2433,2433,2433,2433,2433,2433,2433,2433,2433,2433,2433,2433,2433,2433,2441,2441,2441,2441,2441,2441,2441,2441,2441,2441,2441,2441,2441,2441,2441,2441,2441,2441,2441,2441,2441,2441,2441,2441,2433,2433,2433,2433,2433,2433,2433,2433,2433,2433,2433,2433,2433,2433,2433,2433,2433,2433,2433,2433
2433,2433,2433,2433,2433,2433,2433,2433,2433,2433,2433,2433,2433,2433,2433,2433,2433,2433,2433,2433,2433,2433,2433,2441,2441,2441,2441,2441,2441,2441,2441,2441,2441,2441,2441,2441,2441,2441,2441,2441,2441,2441,2441,2441,2433,2433,2433,2433,2433,2433,2433,2433,2433,2433,2433,2433,2433,2433,2433,2433,2433,2433,2433,2433
2433,2433,2433,2433,2433,2433,2433,2433,2433,2433,2433,2433,2433,2433,2433,2433,2433,2433,2433,2433,2433,2433,2433,2441,2441,2441,2441,2441,2441,2441,2441,2441,2441,2441,2441,2441,2441,2441,2441,2441,2441,2441,2441,2441,2433,2433,2433,2433,2433,2433,2433,2433,2433,2433,2433,2433,2433,2433,2433,2433,2433,2433,2433,2433
2433,2433,2433,2433,2433,2433,2433,2433,2433,2433,2433,2433,2433,2433,2433,2433,2433,2433,2433,2433,2433,2433,2441,2441,2441,2441,2441,2441,2441,2441,2441,2441,2433,2441,2441,2441,2441,2441,2441,2441,2441,2441,2441,2441,2433,2433,2433,2433,2433,2433,2433,2433,2433,2433,2433,2433,2433,2433,2433,2433,2433,2433,2433,2433
2433,2433,2433,2433,2433,2433,2433,2433,2433,2433,2433,2433,2433,2433,2433,2433,2433,2433,2433,2433,2433,2433,2441,2441,2441,2441,2441,2441,2441,2441,2441,2441,2441,2441,2441,2441,2441,2441,2441,2441,2441,2441,2441,2441,2433,2433,2433,2433,2433,2433,2433,2433,2433,2433,2433,2433,2433,2433,2433,2433,2433,2433,2433,2433
2433,2433,2433,2433,2433,2433,2433,2433,2433,2433,2433,2433,2433,2433,2433,2433,2433,2433,2433,2433,2433,2433,2441,2441,2441,2441,2441,2441,2441,2441,2441,2441,2441,2441,2441,2441,2441,2441,2441,2441,2441,2441,2441,2441,2433,2433,2433,2433,2433,2433,2433,2433,2433,2433,2433,2433,2433,2433,2433,2433,2433,2433,2433,2433
2433,2433,2433,2433,2433,2433,2433,2433,2433,2433,2433,2433,2433,2433,2433,2433,2433,2433,2433,2433,2433,2433,2441,2441,2441,2441,2441,2441,2441,2441,2441,2441,2441,2441,2441,2441,2441,2441,2441,2441,2441,2441,2441,2441,2433,2433,2433,2433,2433,2433,2433,2433,2433,2433,2433,2433,2433,2433,2433,2433,2433,2433,2433,2433
2433,2433,2433,2433,2433,2433,2433,2433,2433,2433,2433,2433,2433,2433,2433,2433,2433,2433,2433,2433,2433,2433,2433,2433,2433,2441,2441,2441,2441,2441,2441,2433,2441,2441,2441,2441,2441,2441,2441,2441,2441,2441,2441,2433,2433,2433,2433,2433,2433,2433,2433,2433,2433,2433,2433,2433,2433,2433,2433,2433,2433,2433,2433,2433
2433,2433,2433,2433,2433,2433,2433,2433,2433,2433,2433,2433,2433,2433,2433,2433,2433,2433,2433,2433,2433,2433,2433,2433,2441,2441,2441,2441,2441,2441,2441,2441,2441,2441,2441,2441,2441,2441,2441,2441,2441,2441,2441,2433,2433,2433,2433,2433,2433,2433,2433,2433,2433,2433,2433,2433,2433,2433,2433,2433,2433,2433,2433,2433
2433,2433,2433,2433,2433,2433,2433,2433,2433,2433,2433,2433,2433,2433,2433,2433,2433,2433,2433,2433,2433,2433,2433,2441,2441,2441,2441,2441,2441,2441,2433,2441,2441,2441,2441,2441,2441,2441,2441,2441,2441,2441,2441,2433,2433,2433,2433,2433,2433,2433,2433,2433,2433,2433,2433,2433,2433,2433,2433,2433,2433,2433,2433,2433
2441,2433,2433,2433,2433,2433,2433,2433,2433,2433,2433,2433,2433,2433,2433,2433,2433,2433,2433,2433,2433,2433,2441,2441,2441,2441,2441,2441,2441,2441,2441,2441,2441,2441,2441,2441,2441,2433,2433,2433,2433,2433,2433,2433,2433,2433,2433,2433,2433,2433,2433,2433,2433,2433,2433,2433,2433,2433,2433,2433,2433,2433,2433,2433
2441,2433,2433,2433,2433,2433,2433,2433,2433,2433,2433,2433,2433,2433,2433,2433,2433,2433,2433,2433,2433,2441,2441,2441,2441,2441,2441,2441,2441,2441,2441,2441,2441,2441,2441,2441,2441,2441,2441,2441,2441,2433,2433,2433,2433,2433,2433,2433,2433,2433,2433,2433,2433,2433,2433,2433,2433,2433,2433,2433,2433,2433,2433,2433
2441,2433,2433,2433,2433,2433,2433,2433,2433,2433,2433,2433,2433,2433,2433,2433,2433,2433,2433,2433,2441,2441,2441,2441,2441,2441,2441,2441,2441,2441,2441,2441,2441,2441,2441,2441,2441,2441,2441,2441,2441,2433,2433,2433,2433,2433,2433,2433,2433,2433,2433,2433,2433,2433,2433,2433,2433,2433,2433,2433,2433,2433,2433,2433
2441,2433,2433,2433,2433,2433,2433,2433,2433,2433,2433,2433,2433,2433,2433,2433,2433,2433,2433,2441,2441,2441,2441,2441,2441,2441,2441,2441,2441,2441,2441,2441,2441,2441,2441,2441,2441,2441,2441,2441,2441,2433,2433,2433,2433,2433,2433,2433,2433,2433,2433,2433,2433,2433,2433,2433,2433,2433,2433,2433,2433,2433,2433,2433
2441,2433,2433,2433,2433,2433,2433,2433,2433,2433,2433,2433,2433,2433,2433,2433,2433,2441,2441,2441,2441,2441,2441,2441,2441,2441,2441,2441,2441,2441,2441,2441,2441,2441,2441,2441,2441,2441,2441,2441,2441,2433,2433,2433,2433,2433,2433,2433,2433,2433,2433,2433,2433,2433,2433,2433,2433,2433,2433,2433,2433,2433,2433,2433
2441,2433,2433,2433,2433,2433,2433,2433,2433,2433,2433,2433,2433,2433,2433,2433,2441,2441,2441,2441,2441,2441,2441,2441,2441,2441,2441,2441,2441,2441,2441,2441,2441,2441,2441,2441,2441,2441,2441,2441,2441,2441,2433,2433,2433,2433,2433,2433,2433,2433,2433,2433,2433,2433,2433,2433,2433,2433,2433,2433,2433,2433,2433,2433
2441,2433,2433,2433,2433,2433,2433,2433,2433,2433,2433,2433,2433,2433,2433,2433,2441,2441,2441,2441,2441,2441,2441,2441,2441,2441,2441,2441,2441,2441,2441,2441,2441,2441,2441,2441,2441,2441,2441,2441,2441,2441,2433,2433,2433,2433,2433,2433,2433,2433,2433,2433,2433,2433,2433,2433,2433,2433,2433,2433,2433,2433,2433,2433
2441,2433,2433,2433,2433,2433,2433,2433,2433,2433,2433,2433,2433,2433,2433,2441,2441,2441,2441,2441,2441,2441,2441,2441,2441,2441,2441,2441,2441,2441,2441,2441,2441,2441,2441,2441,2441,2441,2441,2441,2441,2441,2433,2433,2433,2433,2433,2433,2433,2433,2433,2433,2433,2433,2433,2433,2433,2433,2433,2433,2433,2433,2433,2433
2441,2433,2433,2433,2433,2433,2433,2433,2433,2433,2433,2433,2433,2433,2433,2441,2441,2441,2441,2441,2441,2441,2441,2441,2441,2441,2441,2441,2441,2441,2441,2441,2441,2441,2441,2441,2441,2441,2441,2441,2441,2441,2433,2433,2433,2433,2433,2433,2433,2433,2433,2433,2433,2433,2433,2433,2433,2433,2433,2433,2433,2433,2433,2433
2441,2433,2433,2433,2433,2433,2433,2433,2433,2433,2433,2433,2433,2433,2433,2441,2441,2441,2441,2441,2441,2441,2441,2441,2441,2441,2441,2441,2441,2441,2441,2441,2441,2441,2441,2441,2441,2441,2441,2441,2441,2441,2433,2433,2433,2433,2433,2433,2433,2433,2433,2433,2433,2433,2433,2433,2433,2433,2433,2433,2433,2433,2433,2433
2441,2433,2433,2433,2433,2433,2433,2433,2433,2433,2433,2433,2433,2433,2433,2441,2441,2441,2441,2441,2441,2441,2441,2441,2441,2441,2441,2441,2441,2441,2441,2441,2441,2441,2441,2441,2441,2441,2441,2441,2441,2441,2433,2433,2433,2433,2433,2433,2433,2433,2433,2433,2433,2433,2433,2433,2433,2433,2433,2433,2433,2433,2433,2433
2441,2433,2433,2433,2433,2433,2433,2433,2433,2433,2433,2433,2433,2433,2433,2441,2441,2441,2441,2441,2441,2441,2441,2441,2441,2441,2441,2441,2441,2441,2441,2441,2441,2441,2441,2441,2441,2441,2441,2441,2441,2441,2433,2433,2433,2433,2433,2433,2433,2433,2433,2433,2433,2433,2433,2433,2433,2433,2433,2433,2433,2433,2433,2433
2441,2433,2433,2433,2433,2433,2433,2433,2433,2433,2433,2433,2433,2433,2433,2441,2441,2441,2441,2441,2441,2441,2441,2441,2441,2441,2441,2441,2441,2441,2441,2441,2441,2441,2441,2441,2441,2441,2441,2441,2441,2441,2441,2441,2433,2433,2433,2433,2433,2433,2433,2433,2433,2433,2433,2433,2433,2433,2433,2433,2433,2433,2433,2433
2441,2433,2433,2433,2433,2433,2433,2433,2433,2433,2433,2433,2433,2433,2433,2441,2441,2441,2441,2441,2441,2441,2441,2441,2441,2441,2441,2441,2441,2441,2441,2441,2441,2441,2441,2441,2441,2441,2441,2441,2441,2441,2441,2441,2441,2433,2433,2433,2433,2433,2433,2433,2433,2433,2433,2433,2433,2433,2433,2433,2433,2433,2433,2433
2441,2433,2433,2433,2433,2433,2433,2433,2433,2433,2433,2433,2433,2433,2433,2441,2441,2441,2441,2441,2441,2441,2441,2441,2441,2441,2441,2441,2441,2441,2441,2441,2441,2441,2441,2441,2441,2441,2441,2441,2441,2441,2441,2441,2441,2433,2433,2433,2433,2433,2433,2433,2433,2433,2433,2433,2433,2433,2433,2433,2433,2433,2433,2433
2441,2433,2433,2433,2433,2433,2433,2433,2433,2433,2433,2433,2433,2433,2433,2441,2441,2441,2441,2441,2441,2441,2441,2441,2441,2441,2441,2441,2441,2441,2441,2441,2441,2441,2441,2441,2441,2441,2441,2441,2441,2441,2441,2441,2441,2433,2433,2433,2433,2433,2433,2433,2433,2433,2433,2433,2433,2433,2433,2433,2433,2433,2433,2433
2441,2433,2433,2433,2433,2433,2433,2433,2433,2433,2433,2433,2433,2433,2433,2441,2441,2441,2441,2441,2441,2441,2441,2441,2441,2441,2441,2441,2441,2441,2441,2441,2441,2441,2441,2441,2441,2441,2441,2441,2441,2441,2441,2441,2441,2433,2433,2433,2433,2433,2433,2433,2433,2433,2433,2433,2433,2433,2433,2433,2433,2433,2433,2433
2441,2433,2433,2433,2433,2433,2433,2433,2433,2433,2433,2433,2433,2433,2433,2433,2441,2441,2441,2441,2441,2441,2441,2441,2441,2441,2441,2441,2441,2441,2441,2441,2441,2441,2441,2441,2441,2441,2441,2441,2441,2441,2441,2441,2441,2433,2433,2433,2433,2433,2433,2433,2433,2433,2433,2433,2433,2433,2433,2433,2433,2433,2433,2433
2433,2433,2433,2433,2433,2433,2433,2433,2433,2433,2433,2433,2433,2433,2433,2433,2441,2441,2441,2441,2441,2441,2441,2441,2441,2441,2441,2441,2441,2441,2441,2441,2441,2441,2441,2441,2441,2441,2441,2441,2441,2441,2441,2441,2441,2433,2433,2433,2433,2433,2433,2433,2433,2433,2433,2433,2433,2433,2433,2433,2433,2433,2433,2433
2433,2433,2433,2433,2433,2433,2433,2433,2433,2433,2433,2433,2433,2433,2433,2433,2433,2441,2441,2441,2441,2441,2441,2441,2441,2441,2441,2441,2441,2441,2441,2441,2441,2441,2441,2441,2441,2441,2441,2441,2441,2441,2441,2441,2441,2433,2433,2433,2433,2433,2433,2433,2433,2433,2433,2433,2433,2433,2433,2433,2433,2433,2433,2433
2433,2433,2433,2433,2433,2433,2433,2433,2433,2433,2433,2433,2433,2433,2433,2433,2433,2441,2441,2441,2441,2441,2441,2441,2441,2441,2441,2441,2441,2441,2441,2441,2441,2441,2441,2441,2441,2441,2441,2441,2441,2441,2441,2441,2441,2433,2433,2433,2433,2433,2433,2433,2433,2433,2433,2433,2433,2433,2433,2433,2433,2433,2433,2433
2433,2433,2433,2433,2433,2433,2433,2433,2433,2433,2433,2433,2433,2433,2433,2433,2433,2433,2441,2441,2441,2441,2441,2441,2441,2441,2441,2441,2441,2441,2441,2441,2441,2441,2441,2441,2441,2441,2441,2441,2441,2441,2441,2441,2441,2433,2433,2433,2433,2433,2433,2433,2433,2433,2433,2433,2433,2433,2433,2433,2433,2433,2433,2433
2433,2433,2433,2433,2433,2433,2433,2433,2433,2433,2433,2433,2433,2433,2433,2433,2433,2433,2433,2441,2441,2441,2441,2441,2441,2441,2441,2441,2441,2441,2441,2441,2441,2441,2441,2441,2441,2441,2441,2441,2441,2441,2441,2441,2441,2433,2433,2433,2433,2433,2433,2433,2433,2433,2433,2433,2433,2433,2433,2433,2433,2433,2433,2433
2433,2433,2433,2433,2433,2433,2433,2433,2433,2433,2433,2433,2433,2433,2433,2433,2433,2433,2433,2441,2441,2441,2441,2441,2441,2441,2441,2441,2441,2441,2441,2441,2441,2441,2441,2441,2441,2441,2441,2441,2441,2441,2441,2441,2441,2433,2433,2433,2433,2433,2433,2433,2433,2433,2433,2433,2433,2433,2433,2433,2433,2433,2433,2433
2433,2433,2433,2433,2433,2433,2433,2433,2433,2433,2433,2433,2433,2433,2433,2433,2433,2433,2433,2441,2441,2441,2441,2441,2441,2441,2441,2441,2441,2441,2441,2441,2441,2441,2441,2441,2441,2441,2441,2441,2441,2441,2441,2441,2441,2433,2433,2433,2433,2433,2433,2433,2433,2433,2433,2433,2433,2433,2433,2433,2433,2433,2433,2433
2433,2433,2433,2433,2433,2433,2433,2433,2433,2433,2433,2433,2433,2433,2433,2433,2433,2433,2433,2433,2441,2441,2441,2441,2441,2441,2441,2441,2441,2441,2441,2441,2441,2441,2441,2441,2441,2441,2441,2441,2441,2441,2441,2441,2441,2433,2433,2433,2433,2433,2433,2433,2433,2433,2433,2433,2433,2433,2433,2433,2433,2433,2433,2433
2433,2433,2433,2433,2433,2433,2433,2433,2433,2433,2433,2433,2433,2433,2433,2433,2433,2433,2433,2433,2441,2441,2441,2441,2441,2441,2441,2441,2441,2441,2441,2441,2441,2441,2441,2441,2441,2441,2441,2441,2441,2441,2441,2441,2441,2433,2433,2433,2433,2433,2433,2433,2433,2433,2433,2433,2433,2433,2433,2433,2433,2433,2433,2433
2433,2433,2433,2433,2433,2433,2433,2433,2433,2433,2433,2433,2433,2433,2433,2433,2433,2433,2433,2433,2433,2441,2441,2441,2441,2441,2441,2441,2441,2441,2441,2441,2441,2441,2441,2441,2441,2441,2441,2441,2441,2441,2441,2441,2441,2433,2433,2433,2433,2433,2433,2433,2433,2433,2433,2433,2433,2433,2433,2433,2433,2433,2433,2433
2433,2433,2433,2433,2433,2433,2433,2433,2433,2433,2433,2433,2433,2433,2433,2433,2433,2433,2433,2433,2433,2441,2441,2441,2441,2441,2441,2433,2433,2433,2433,2433,2433,2433,2433,2433,2433,2433,2433,2433,2433,2433,2433,2433,2433,2433,2433,2433,2433,2433,2433,2433,2433,2433,2433,2433,2433,2433,2433,2433,2433,2433,2433,2433
2433,2433,2433,2433,2433,2433,2433,2433,2433,2433,2433,2433,2433,2441,2441,2441,2441,2441,2441,2441,2441,2441,2441,2441,2433,2433,2433,2441,2441,2441,2441,2441,2441,2441,2441,2433,2433,2433,2433,2433,2433,2433,2433,2433,2433,2433,2433,2433,2433,2433,2433,2433,2433,2433,2433,2433,2433,2433,2433,2433,2433,2433,2433,2433
2433,2433,2433,2433,2433,2433,2433,2433,2433,2433,2433,2433,2433,2433,2433,2433,2441,2441,2441,2441,2433,2433,2433,2433,2441,2441,2441,2441,2441,2441,2441,2441,2441,2441,2441,2433,2433,2433,2433,2433,2433,2433,2433,2433,2433,2433,2433,2433,2433,2433,2433,2433,2433,2433,2433,2433,2433,2433,2433,2433,2433,2433,2433,2433
2433,2433,2433,2433,2433,2433,2433,2433,2433,2433,2433,2433,2433,2433,2433,2433,2433,2433,2433,2433,2441,2441,2441,2441,2441,2441,2441,2441,2441,2441,2441,2441,2441,2441,2433,2433,2433,2433,2433,2433,2433,2433,2433,2433,2433,2433,2433,2433,2433,2433,2433,2433,2433,2433,2433,2433,2433,2433,2433,2441,2433,2433,2433,2433
2433,2433,2433,2433,2433,2433,2433,2433,2433,2433,2433,2433,2433,2433,2433,2433,2433,2433,2441,2441,2441,2441,2441,2441,2441,2441,2441,2441,2441,2441,2441,2441,2441,2441,2433,2433,2433,2433,2433,2433,2433,2433,2433,2433,2433,2433,2433,2433,2433,2433,2433,2433,2433,2433,2433,2433,2433,2433,2433,2433,2433,2433,2433,2433
2433,2433,2433,2433,2433,2433,2433,2433,2433,2433,2433,2433,2433,2433,2433,2433,2433,2441,2441,2441,2441,2441,2441,2441,2441,2441,2441,2441,2441,2441,2441,2441,2441,2433,2433,2433,2433,2433,2433,2433,2433,2433,2433,2433,2433,2433,2433,2433,2433,2433,2433,2433,2433,2433,2433,2433,2433,2433,2441,2433,2433,2433,2433,2433
2433,2433,2433,2433,2433,2433,2433,2433,2433,2433,2433,2433,2433,2433,2433,2433,2433,2441,2441,2441,2441,2441,2441,2441,2441,2441,2441,2441,2441,2441,2441,2441,2433,2433,2433,2433,2433,2433,2433,2433,2433,2433,2433,2433,2433,2433,2433,2433,2433,2433,2433,2433,2433,2433,2433,2433,2433,2441,2433,2433,2433,2433,2433,2433
2433,2433,2433,2433,2433,2433,2433,2433,2433,2433,2433,2433,2433,2433,2433,2433,2441,2441,2441,2441,2441,2441,2441,2441,2441,2441,2441,2441,2441,2441,2441,2433,2433,2433,2433,2433,2433,2433,2433,2433,2433,2433,2433,2433,2433,2433,2433,2433,2433,2433,2433,2433,2433,2433,2433,2433,2441,2433,2433,2433,2433,2433,2441,2441
2433,2433,2433,2433,2433,2433,2433,2433,2433,2433,2433,2433,2433,2433,2441,2441,2441,2441,2441,2441,2441,2441,2441,2441,2441,2441,2441,2441,2441,2433,2433,2433,2433,2433,2433,2433,2433,2433,2433,2433,2433,2433,2433,2433,2433,2433,2433,2433,2433,2433,2433,2433,2433,2433,2433,2441,2433,2433,2441,2441,2441,2441,2441,2441
2433,2433,2433,2433,2433,2433,2433,2433,2433,2433,2433,2433,2433,2441,2441,2441,2441,2441,2441,2441,2433,2433,2433,2433,2433,2433,2433,2433,2433,2433,2433,2433,2433,2433,2433,2433,2433,2433,2433,2433,2433,2433,2433,2433,2433,2433,2433,2433,2433,2433,2433,2433,2433,2441,2441,2441,2441,2441,2441,2441,2441,2441,2441,2441
2433,2433,2433,2433,2433,2433,2433,2441,2441,2441,2441,2441,2441,2441,2441,2441,2441,2441,2441,2441,2433,2433,2433,2433,2433,2433,2433,2433,2433,2433,2433,2433,2433,2433,2433,2433,2433,2433,2433,2433,2433,2433,2433,2433,2433,2441,2441,2441,2441,2441,2441,2441,2441,2441,2441,2441,2441,2441,2441,2441,2441,2441,2441,2441
2433,2433,2433,2433,2433,2441,2441,2441,2441,2441,2441,2441,2441,2441,2441,2441,2441,2441,2441,2433,2433,2433,2433,2433,2433,2433,2433,2433,2433,2433,2433,2433,2433,2433,2433,2433,2433,2433,2433,2433,2433,2433,2433,2433,2441,2441,2441,2441,2441,2441,2441,2441,2441,2441,2441,2441,2441,2441,2441,2441,2441,2441,2441,2441
2433,2433,2433,2433,2441,2441,2441,2441,2441,2441,2441,2441,2441,2441,2441,2441,2441,2441,2441,2433,2433,2433,2433,2433,2433,2433,2433,2433,2433,2433,2433,2433,2433,2433,2433,2433,2433,2433,2433,2433,2433,2433,2433,2433,2441,2441,2441,2441,2441,2441,2441,2441,2441,2441,2441,2441,2441,2441,2441,2441,2441,2441,2441,2441
2433,2433,2433,2441,2441,2441,2441,2441,2441,2441,2441,2441,2441,2441,2441,2441,2441,2441,2441,2433,2433,2433,2433,2433,2433,2433,2433,2433,2433,2433,2433,2433,2433,2433,2433,2433,2433,2433,2433,2433,2433,2433,2433,2433,2441,2441,2441,2441,2441,2441,2441,2441,2441,2441,2441,2441,2441,2441,2441,2441,2441,2441,2441,2441
2441,2441,2441,2441,2441,2441,2441,2441,2441,2441,2441,2441,2441,2441,2441,2441,2441,2441,2441,2433,2433,2433,2433,2433,2433,2433,2433,2433,2433,2433,2433,2433,2433,2433,2433,2433,2433,2433,2433,2433,2433,2433,2433,2433,2441,2441,2441,2441,2441,2441,2441,2441,2441,2441,2441,2441,2441,2441,2441,2441,2441,2441,2441,2441
