2465,2465,2465,2465,2465,2465,2465,2465,2465,2465,2465,2465,2465,2465,2465,2465,2465,2465,2465,2465,2465,2465,2465,2465,2465,2465,2465,2465,2465,2465,2465,2465,2465,2465,2465,2465,2465,2465,2465,2465,2465,2465,2465,2465,2465,2465,2465,2465,2465,2465,2465,2465,2465,2465,2465,2465,2465,2465,2465,2465,2465,2465,2465,2465
2465,2465,2465,2465,2465,2465,2465,2465,2465,2465,2465,2465,2465,2465,2465,2465,2465,2465,2465,2465,2465,2465,2465,2465,2465,2465,2465,2465,2465,2465,2465,2465,2465,2465,2465,2465,2465,2465,2465,2465,2465,2465,2465,2465,2465,2465,2465,2465,2465,2465,2465,2465,2465,2465,2465,2465,2465,2465,2465,2465,2465,2465,2465,2465
2465,2465,2465,2465,2465,2465,2465,2465,2465,2465,2465,2465,2465,2465,2465,2465,2465,2465,2465,2465,2465,2465,2465,2465,2465,2465,2465,2465,2465,2465,2465,2465,2465,2465,2465,2465,2465,2465,2465,2465,2465,2465,2465,2465,2465,2465,2465,2465,2465,2465,2465,2465,2465,2465,2465,2465,2465,2465,2465,2465,2465,2465,2465,2465
2465,2465,2465,2465,2465,2465,2465,2465,2465,2465,2465,2465,2465,2465,2465,2465,2465,2465,2465,2465,2465,2465,2465,2465,2465,2465,2465,2465,2465,2465,2465,2465,2465,2465,2465,2465,2465,2465,2465,2465,2465,2465,2465,2465,2465,2465,2465,2465,2465,2465,2465,2465,2465,2465,2465,2465,2465,2465,2465,2465,2465,2465,2465,2465
2465,2465,2465,2465,2465,2465,2465,2465,2465,2465,2465,2465,2465,2465,2465,2465,2465,2465,2465,2465,2465,2465,2465,2465,2465,2465,2465,2465,2465,2465,2465,2465,2465,2465,2465,2465,2465,2465,2465,2465,2465,2465,2465,2465,2465,2465,2465,2465,2465,2465,2465,2465,2465,2465,2465,2465,2465,2465,2465,2465,2465,2465,2465,2465
2465,2465,2465,2465,2465,2465,2465,2465,3286,3286,3286,3286,3286,3286,3286,3286,3286,3286,3286,3286,3286,3286,3286,3286,3286,3286,3286,3286,3286,3286,3286,3286,3286,3286,3286,3286,3286,3286,3286,3286,3286,3286,3286,3286,3286,3286,3286,3286,3286,3286,3286,3286,3286,3286,3286,3286,3286,2465,2465,2465,2465,2465,2465,2465
2465,2465,2465,2465,2465,2465,2465,2465,3286,3286,3286,3286,3286,3286,3286,3286,3286,3286,3286,3286,3286,3286,3286,3286,3286,3286,3286,3286,3286,3286,3286,3286,3286,3286,3286,3286,3286,3286,3286,3286,3286,3286,3286,3286,3286,3286,3286,3286,3286,3286,3286,3286,3286,3286,3286,3286,3286,2465,2465,2465,2465,2465,2465,2465
2465,2465,2465,2465,2465,2465,2465,2465,3286,3286,3286,3286,3286,3286,3286,3286,3286,3286,3286,3286,3286,3286,3286,3286,3286,3286,3286,3286,3286,3286,3286,3286,3286,3286,3286,3286,3286,3286,3286,3286,3286,3286,3286,3286,3286,3286,3286,3286,3286,3286,3286,3286,3286,3286,3286,3286,3286,2465,2465,2465,2465,2465,2465,2465
2465,2465,2465,2465,2465,2465,2465,2465,3286,3286,3286,3329,3329,3329,3329,3329,3329,3329,3329,3329,3329,3329,3329,3329,3329,3329,3329,3329,3329,3329,3329,3329,3329,3329,3329,3329,3329,3329,3329,3329,3329,3329,3329,3329,3329,3329,3329,3329,3329,3329,3329,3329,3329,3329,3286,3286,3286,2465,2465,2465,2465,2465,2465,2465
2465,2465,2465,2465,2465,2465,2465,2465,3286,3286,3286,3329,3329,3329,3329,3329,3329,3329,3329,3329,3329,3329,3329,3329,3329,3329,3329,3329,3329,3329,3329,3329,3329,3329,3329,3329,3329,3329,3329,3329,3329,3329,3329,3329,3329,3329,3329,3329,3329,3329,3329,3329,3329,3329,3286,3286,3286,2465,2465,2465,2465,2465,2465,2465
2465,2465,2465,2465,2465,2465,2465,2465,3286,3286,3286,3329,3329,3329,3329,3329,3329,3329,3329,3329,3329,3329,3329,3329,3329,3329,3329,3329,3329,3329,3329,3329,3329,3329,3329,3329,3329,3329,3329,3329,3329,3329,3329,3329,3329,3329,3329,3329,3329,3329,3329,3329,3329,3329,3286,3286,3286,2465,2465,2465,2465,2465,2465,2465
2465,2465,2465,2465,2465,2465,2465,2465,3286,3286,3286,3329,3329,3329,3329,2465,2465,2465,2465,2465,2465,2465,2465,2465,2465,2465,2465,2465,2465,2465,2465,2465,2465,2465,2465,2465,2465,2465,2465,2465,2465,2465,2465,2465,2465,2465,2465,2465,2465,2465,3329,3329,3329,3329,3286,3286,3286,2465,2465,2465,2465,2465,2465,2465
2465,2465,2465,2465,2465,2465,2465,2465,3286,3286,3286,3329,3329,3329,3329,2465,2465,2465,2465,2465,2465,2465,2465,2465,2465,2465,2465,2465,2465,2465,2465,2465,2465,2465,2465,2465,2465,2465,2465,2465,2465,2465,2465,2465,2465,2465,2465,2465,2465,2465,3329,3329,3329,3329,3286,3286,3286,2465,2465,2465,2465,2465,2465,2465
2465,2465,2465,2465,2465,2465,2465,2465,3286,3286,3286,3329,3329,3329,3329,2465,2465,2465,2433,2433,2433,2433,2433,2433,2433,2433,2433,2433,2433,2433,2433,2433,2433,2433,2433,2433,2433,2433,2433,2433,2433,2433,2433,2433,2433,2433,2433,2433,2465,2465,3329,3329,3329,3329,3286,3286,3286,2465,2465,2465,2465,2465,2465,2465
2465,2465,2465,2465,2465,2465,2465,2465,3286,3286,3286,3329,3329,3329,3329,2465,2465,2465,2433,2433,2433,2433,2433,2433,2433,2433,2433,2433,2433,2433,2433,2433,2433,2433,2433,2433,2433,2433,2433,2433,2433,2433,2433,2433,2433,2433,2433,2433,2465,2465,3329,3329,3329,3329,3286,3286,3286,2465,2465,2465,2465,2465,2465,2465
2465,2465,2465,2465,2465,2465,2465,2465,3286,3286,3286,3329,3329,3329,3329,2465,2465,2465,2433,2433,2433,2433,2433,2433,2433,2433,2433,2433,2433,2433,2433,2433,2433,2433,2433,2433,2433,2433,2433,2433,2433,2433,2433,2433,2433,2433,2433,2433,2465,2465,3329,3329,3329,3329,3286,3286,3286,2465,2465,2465,2465,2465,2465,2465
2465,2465,2465,2465,2465,2465,2465,2465,3286,3286,3286,3329,3329,3329,3329,2465,2465,2465,2433,2433,2433,2433,2433,2433,2433,2433,2433,2433,2433,2433,2433,2433,2433,2433,2433,2433,2433,2433,2433,2433,2433,2433,2433,2433,2433,2433,2433,2433,2465,2465,3329,3329,3329,3329,3286,3286,3286,2465,2465,2465,2465,2465,2465,2465
2465,2465,2465,2465,2465,2465,2465,2465,3286,3286,3286,3329,3329,3329,3329,2465,2465,2465,2433,2433,2433,2433,2433,2433,2433,2433,2433,2433,2433,2433,2433,2433,2433,2433,2433,2433,2433,2433,2433,2433,2433,2433,2433,2433,2433,2433,2433,2433,2465,2465,3329,3329,3329,3329,3286,3286,3286,2465,2465,2465,2465,2465,2465,2465
2465,2465,2465,2465,2465,2465,2465,2465,3286,3286,3286,3329,3329,3329,3329,2465,2465,2465,2433,2433,2433,2433,2433,2433,2433,2433,2433,2433,2433,2433,2433,2433,2433,2433,2433,2433,2433,2433,2433,2433,2433,2433,2433,2433,2433,2433,2433,2433,2465,2465,3329,3329,3329,3329,3286,3286,3286,2465,2465,2465,2465,2465,2465,2465
2465,2465,2465,2465,2465,2465,2465,2465,3286,3286,3286,3329,3329,3329,3329,2465,2465,2465,2433,2433,2433,2433,2433,2433,2433,2433,2433,2433,2433,2433,2433,2433,2433,2433,2433,2433,2433,2433,2433,2433,2433,2433,2433,2433,2433,2433,2433,2433,2465,2465,3329,3329,3329,3329,3286,3286,3286,2465,2465,2465,2465,2465,2465,2465
2465,2465,2465,2465,2465,2465,2465,2465,3286,3286,3286,3329,3329,3329,3329,2465,2465,2465,2433,2433,2433,2433,2433,2433,2433,2433,2433,2433,2433,2433,2433,2433,2433,2433,2433,2433,2433,2433,2433,2433,2433,2433,2433,2433,2433,2433,2433,2433,2465,2465,3329,3329,3329,3329,3286,3286,3286,2465,2465,2465,2465,2465,2465,2465
2465,2465,2465,2465,2465,2465,2465,2465,3286,3286,3286,3329,3329,3329,3329,2465,2465,2465,2433,2433,2433,2433,2433,2433,2433,2433,2433,2433,2433,2433,2433,2433,2433,2433,2433,2433,2433,2433,2433,2433,2433,2433,2433,2433,2433,2433,2433,2433,2465,2465,3329,3329,3329,3329,3286,3286,3286,2465,2465,2465,2465,2465,2465,2465
2465,2465,2465,2465,2465,2465,2465,2465,3286,3286,3286,3329,3329,3329,3329,2465,2465,2465,2433,2433,2433,2433,2433,2433,2433,2433,2433,2433,2433,2433,2433,2433,2433,2433,2433,2433,2433,2433,2433,2433,2433,2433,2433,2433,2433,2433,2433,2433,2465,2465,3329,3329,3329,3329,3286,3286,3286,2465,2465,2465,2465,2465,2465,2465
2465,2465,2465,2465,2465,2465,2465,2465,3286,3286,3286,3329,3329,3329,3329,2465,2465,2465,2433,2433,2433,2433,2433,2433,2433,2433,2433,2433,2433,2433,2433,2433,2433,2433,2433,2433,2433,2433,2433,2433,2433,2433,2433,2433,2433,2433,2433,2433,2465,2465,3329,3329,3329,3329,3286,3286,3286,2465,2465,2465,2465,2465,2465,2465
2465,2465,2465,2465,2465,2465,2465,2465,3286,3286,3286,3329,3329,3329,3329,2465,2465,2465,2433,2433,2433,2433,2433,2433,2433,2433,2433,2433,2433,2433,2433,2433,2433,2433,2433,2433,2433,2433,2433,2433,2433,2433,2433,2433,2433,2433,2433,2433,2465,2465,3329,3329,3329,3329,3286,3286,3286,2465,2465,2465,2465,2465,2465,2465
2465,2465,2465,2465,2465,2465,2465,2465,3286,3286,3286,3329,3329,3329,3329,2465,2465,2465,2433,2433,2433,2433,2433,2433,2433,2433,2433,2433,2433,2433,2433,2433,2433,2433,2433,2433,2433,2433,2433,2433,2433,2433,2433,2433,2433,2433,2433,2433,2465,2465,3329,3329,3329,3329,3286,3286,3286,2465,2465,2465,2465,2465,2465,2465
2465,2465,2465,2465,2465,2465,2465,2465,3286,3286,3286,3329,3329,3329,3329,2465,2465,2465,2433,2433,2433,2433,2433,2433,2433,2433,2433,2433,2433,2433,2433,2433,2433,2433,2433,2433,2433,2433,2433,2433,2433,2433,2433,2433,2433,2433,2433,2433,2465,2465,3329,3329,3329,3329,3286,3286,3286,2465,2465,2465,2465,2465,2465,2465
2465,2465,2465,2465,2465,2465,2465,2465,3286,3286,3286,3329,3329,3329,3329,2465,2465,2465,2433,2433,2433,2433,2433,2433,2433,2433,2433,2433,2433,2433,2433,2433,2433,2433,2433,2433,2433,2433,2433,2433,2433,2433,2433,2433,2433,2433,2433,2433,2465,2465,3329,3329,3329,3329,3286,3286,3286,2465,2465,2465,2465,2465,2465,2465
2465,2465,2465,2465,2465,2465,2465,2465,3286,3286,3286,3329,3329,3329,3329,2465,2465,2465,2433,2433,2433,2433,2433,2433,2433,2433,2433,2433,2433,2433,2433,2433,2433,2433,2433,2433,2433,2433,2433,2433,2433,2433,2433,2433,2433,2433,2433,2433,2465,2465,3329,3329,3329,3329,3286,3286,3286,2465,2465,2465,2465,2465,2465,2465
2465,2465,2465,2465,2465,2465,2465,2465,3286,3286,3286,3329,3329,3329,3329,2465,2465,2465,2433,2433,2433,2433,2433,2433,2433,2433,2433,2433,2433,2433,2433,2433,2433,2433,2433,2433,2433,2433,2433,2433,2433,2433,2433,2433,2433,2433,2433,2433,2465,2465,3329,3329,3329,3329,3286,3286,3286,2465,2465,2465,2465,2465,2465,2465
2465,2465,2465,2465,2465,2465,2465,2465,3286,3286,3286,3329,3329,3329,3329,2465,2465,2465,2433,2433,2433,2433,2433,2433,2433,2433,2433,2433,2433,2433,2433,2433,2433,2433,2433,2433,2433,2433,2433,2433,2433,2433,2433,2433,2433,2433,2433,2433,2465,2465,3329,3329,3329,3329,3286,3286,3286,2465,2465,2465,2465,2465,2465,2465
2465,2465,2465,2465,2465,2465,2465,2465,3286,3286,3286,3329,3329,3329,3329,2465,2465,2465,2433,2433,2433,2433,2433,2433,2433,2433,2433,2433,2433,2433,2433,2433,2433,2433,2433,2433,2433,2433,2433,2433,2433,2433,2433,2433,2433,2433,2433,2433,2465,2465,3329,3329,3329,3329,3286,3286,3286,2465,2465,2465,2465,2465,2465,2465
2465,2465,2465,2465,2465,2465,2465,2465,3286,3286,3286,3329,3329,3329,3329,2465,2465,2465,2433,2433,2433,2433,2433,2433,2433,2433,2433,2433,2433,2433,2433,2433,2433,2433,2433,2433,2433,2433,2433,2433,2433,2433,2433,2433,2433,2433,2433,2433,2465,2465,3329,3329,3329,3329,3286,3286,3286,2465,2465,2465,2465,2465,2465,2465
2465,2465,2465,2465,2465,2465,2465,2465,3286,3286,3286,3329,3329,3329,3329,2465,2465,2465,2433,2433,2433,2433,2433,2433,2433,2433,2433,2433,2433,2433,2433,2433,2433,2433,2433,2433,2433,2433,2433,2433,2433,2433,2433,2433,2433,2433,2433,2433,2465,2465,3329,3329,3329,3329,3286,3286,3286,2465,2465,2465,2465,2465,2465,2465
2465,2465,2465,2465,2465,2465,2465,2465,3286,3286,3286,3329,3329,3329,3329,2465,2465,2465,2433,2433,2433,2433,2433,2433,2433,2433,2433,2433,2433,2433,2433,2433,2433,2433,2433,2433,2433,2433,2433,2433,2433,2433,2433,2433,2433,2433,2433,2433,2465,2465,3329,3329,3329,3329,3286,3286,3286,2465,2465,2465,2465,2465,2465,2465
2465,2465,2465,2465,2465,2465,2465,2465,3286,3286,3286,3329,3329,3329,3329,2465,2465,2465,2433,2433,2433,2433,2433,2433,2433,2433,2433,2433,2433,2433,2433,2433,2433,2433,2433,2433,2433,2433,2433,2433,2433,2433,2433,2433,2433,2433,2433,2433,2465,2465,3329,3329,3329,3329,3286,3286,3286,2465,2465,2465,2465,2465,2465,2465
2465,2465,2465,2465,2465,2465,2465,2465,3286,3286,3286,3329,3329,3329,3329,2465,2465,2465,2433,2433,2433,2433,2433,2433,2433,2433,2433,2433,2433,2433,2433,2433,2433,2433,2433,2433,2433,2433,2433,2433,2433,2433,2433,2433,2433,2433,2433,2433,2465,2465,3329,3329,3329,3329,3286,3286,3286,2465,2465,2465,2465,2465,2465,2465
2465,2465,2465,2465,2465,2465,2465,2465,3286,3286,3286,3329,3329,3329,3329,2465,2465,2465,2433,2433,2433,2433,2433,2433,2433,2433,2433,2433,2433,2433,2433,2433,2433,2433,2433,2433,2433,2433,2433,2433,2433,2433,2433,2433,2433,2433,2433,2433,2465,2465,3329,3329,3329,3329,3286,3286,3286,2465,2465,2465,2465,2465,2465,2465
2465,2465,2465,2465,2465,2465,2465,2465,3286,3286,3286,3329,3329,3329,3329,2465,2465,2465,2433,2433,2433,2433,2433,2433,2433,2433,2433,2433,2433,2433,2433,2433,2433,2433,2433,2433,2433,2433,2433,2433,2433,2433,2433,2433,2433,2433,2433,2433,2465,2465,3329,3329,3329,3329,3286,3286,3286,2465,2465,2465,2465,2465,2465,2465
2465,2465,2465,2465,2465,2465,2465,2465,3286,3286,3286,3329,3329,3329,3329,2465,2465,2465,2433,2433,2433,2433,2433,2433,2433,2433,2433,2433,2433,2433,2433,2433,2433,2433,2433,2433,2433,2433,2433,2433,2433,2433,2433,2433,2433,2433,2433,2433,2465,2465,3329,3329,3329,3329,3286,3286,3286,2465,2465,2465,2465,2465,2465,2465
2465,2465,2465,2465,2465,2465,2465,2465,3286,3286,3286,3329,3329,3329,3329,2465,2465,2465,2433,2433,2433,2433,2433,2433,2433,2433,2433,2433,2433,2433,2433,2433,2433,2433,2433,2433,2433,2433,2433,2433,2433,2433,2433,2433,2433,2433,2433,2433,2465,2465,3329,3329,3329,3329,3286,3286,3286,2465,2465,2465,2465,2465,2465,2465
2465,2465,2465,2465,2465,2465,2465,2465,3286,3286,3286,3329,3329,3329,3329,2465,2465,2465,2433,2433,2433,2433,2433,2433,2433,2433,2433,2433,2433,2433,2433,2433,2433,2433,2433,2433,2433,2433,2433,2433,2433,2433,2433,2433,2433,2433,2433,2433,2465,2465,3329,3329,3329,3329,3286,3286,3286,2465,2465,2465,2465,2465,2465,2465
2465,2465,2465,2465,2465,2465,2465,2465,3286,3286,3286,3329,3329,3329,3329,2465,2465,2465,2433,2433,2433,2433,2433,2433,2433,2433,2433,2433,2433,2433,2433,2433,2433,2433,2433,2433,2433,2433,2433,2433,2433,2433,2433,2433,2433,2433,2433,2433,2465,2465,3329,3329,3329,3329,3286,3286,3286,2465,2465,2465,2465,2465,2465,2465
2465,2465,2465,2465,2465,2465,2465,2465,3286,3286,3286,3329,3329,3329,3329,2465,2465,2465,2433,2433,2433,2433,2433,2433,2433,2433,2433,2433,2433,2433,2433,2433,2433,2433,2433,2433,2433,2433,2433,2433,2433,2433,2433,2433,2433,2433,2433,2433,2465,2465,3329,3329,3329,3329,3286,3286,3286,2465,2465,2465,2465,2465,2465,2465
2465,2465,2465,2465,2465,2465,2465,2465,3286,3286,3286,3329,3329,3329,3329,2465,2465,2465,2433,2433,2433,2433,2433,2433,2433,2433,2433,2433,2433,2433,2433,2433,2433,2433,2433,2433,2433,2433,2433,2433,2433,2433,2433,2433,2433,2433,2433,2433,2465,2465,3329,3329,3329,3329,3286,3286,3286,2465,2465,2465,2465,2465,2465,2465
2465,2465,2465,2465,2465,2465,2465,2465,3286,3286,3286,3329,3329,3329,3329,2465,2465,2465,2433,2433,2433,2433,2433,2433,2433,2433,2433,2433,2433,2433,2433,2433,2433,2433,2433,2433,2433,2433,2433,2433,2433,2433,2433,2433,2433,2433,2433,2433,2465,2465,3329,3329,3329,3329,3286,3286,3286,2465,2465,2465,2465,2465,2465,2465
2465,2465,2465,2465,2465,2465,2465,2465,3286,3286,3286,3329,3329,3329,3329,2465,2465,2465,2433,2433,2433,2433,2433,2433,2433,2433,2433,2433,2433,2433,2433,2433,2433,2433,2433,2433,2433,2433,2433,2433,2433,2433,2433,2433,2433,2433,2433,2433,2465,2465,3329,3329,3329,3329,3286,3286,3286,2465,2465,2465,2465,2465,2465,2465
2465,2465,2465,2465,2465,2465,2465,2465,3286,3286,3286,3329,3329,3329,3329,2465,2465,2465,2433,2433,2433,2433,2433,2433,2433,2433,2433,2433,2433,2433,2433,2433,2433,2433,2433,2433,2433,2433,2433,2433,2433,2433,2433,2433,2433,2433,2433,2433,2465,2465,3329,3329,3329,3329,3286,3286,3286,2465,2465,2465,2465,2465,2465,2465
2465,2465,2465,2465,2465,2465,2465,2465,3286,3286,3286,3329,3329,3329,3329,2465,2465,2465,2433,2433,2433,2433,2433,2433,2433,2433,2433,2433,2433,2433,2433,2433,2433,2433,2433,2433,2433,2433,2433,2433,2433,2433,2433,2433,2433,2433,2433,2433,2465,2465,3329,3329,3329,3329,3286,3286,3286,2465,2465,2465,2465,2465,2465,2465
2465,2465,2465,2465,2465,2465,2465,2465,3286,3286,3286,3329,3329,3329,3329,2465,2465,2465,2465,2465,2465,2465,2465,2465,2465,2465,2465,2465,2465,2465,2465,2465,2465,2465,2465,2465,2468,2468,2468,2468,2468,2468,2468,2465,2465,2465,2465,2465,2465,2465,3329,3329,3329,3329,3286,3286,3286,2465,2465,2465,2465,2465,2465,2465
2465,2465,2465,2465,2465,2465,2465,2465,3286,3286,3286,3329,3329,3329,3329,2465,2465,2465,2465,2465,2465,2465,2465,2465,2465,2465,2465,2465,2465,2465,2465,2465,2465,2465,2465,2465,2465,2465,2465,2465,2465,2465,2465,2468,2465,2465,2465,2465,2465,2465,3329,3329,3329,3329,3286,3286,3286,2465,2465,2465,2465,2465,2465,2465
2465,2465,2465,2465,2465,2465,2465,2465,3286,3286,3286,3329,3329,3329,3329,3329,3329,3329,3329,3329,3329,3329,3329,3329,3329,3329,3329,3329,3329,3329,3329,3329,3329,3329,3329,3329,3329,3329,3329,3329,3329,3329,3329,3329,3329,3329,3329,3329,3329,3329,3329,3329,3329,3329,3286,3286,3286,2465,2465,2465,2465,2465,2465,2465
2465,2465,2465,2465,2465,2465,2465,2465,3286,3286,3286,3329,3329,3329,3329,3329,3329,3329,3329,3329,3329,3329,3329,3329,3329,3329,3329,3329,3329,3329,3329,3329,3329,3329,3329,3329,3329,3329,3329,3329,3329,3329,3329,3329,3329,3329,3329,3329,3329,3329,3329,3329,3329,3329,3286,3286,3286,2465,2465,2465,2465,2465,2465,2465
2465,2465,2465,2465,2465,2465,2465,2465,3286,3286,3286,3329,3329,3329,3329,3329,3329,3329,3329,3329,3329,3329,3329,3329,3329,3329,3329,3329,3329,3329,3329,3329,3329,3329,3329,3329,3329,3329,3329,3329,3329,3329,3329,3329,3329,3329,3329,3329,3329,3329,3329,3329,3329,3329,3286,3286,3286,2465,2465,2465,2465,2465,2465,2465
2465,2465,2465,2465,2465,2465,2465,2465,3286,3286,3286,3329,3329,3329,3329,3329,3329,3329,3329,3329,3329,3329,3329,3329,3329,3329,3329,3329,3329,3329,3329,3329,3329,3329,3329,3329,3329,3329,3329,3329,3329,3329,3329,3329,3329,3329,3329,3329,3329,3329,3329,3329,3329,3329,3286,3286,3286,2465,2465,2465,2465,2465,2465,2465
2465,2465,2465,2465,2465,2465,2465,2465,3286,3286,3286,3329,3329,3329,3329,3329,3329,3329,3329,3329,3329,3329,3329,3329,3329,3329,3329,3329,3329,3329,3329,3329,3329,3329,3329,3329,3329,3329,3329,3329,3329,3329,3329,3329,3329,3329,3329,3329,3329,3329,3329,3329,3329,3329,3286,3286,3286,2465,2465,2465,2465,2465,2465,2465
2465,2465,2465,2465,2465,2465,2465,2465,3286,3286,3286,3286,3286,3286,3286,3286,3286,3286,3286,3286,3286,3286,3286,3286,3286,3286,3286,3286,3286,3286,3286,3286,3286,3286,3286,3286,3286,3286,3286,3286,3286,3286,3286,3286,3286,3286,3286,3286,3286,3286,3286,3286,3286,3286,3286,3286,3286,2465,2465,2465,2465,2465,2465,2465
2465,2465,2465,2465,2465,2465,2465,2465,3286,3286,3286,3286,3286,3286,3286,3286,3286,3286,3286,3286,3286,3286,3286,3286,3286,3286,3286,3286,3286,3286,3286,3286,3286,3286,3286,3286,3286,3286,3286,3286,3286,3286,3286,3286,3286,3286,3286,3286,3286,3286,3286,3286,3286,3286,3286,3286,3286,2465,2465,2465,2465,2465,2465,2465
2465,2465,2465,2465,2465,2465,2465,2465,3286,3286,3286,3286,3286,3286,3286,3286,3286,3286,3286,3286,3286,3286,3286,3286,3286,3286,3286,3286,3286,3286,3286,3286,3286,3286,3286,3286,3286,3286,3286,3286,3286,3286,3286,3286,3286,3286,3286,3286,3286,3286,3286,3286,3286,3286,3286,3286,3286,2465,2465,2465,2465,2465,2465,2465
2465,2465,2465,2465,2465,2465,2465,2465,2465,2465,2465,2465,2465,2465,2465,2465,2465,2465,2465,2465,2465,2465,2465,2465,2465,2465,2465,2465,2465,2465,2465,2465,2465,2465,2465,2465,2465,2465,2465,2465,2465,2465,2465,2465,2465,2465,2465,2465,2465,2465,2465,2465,2465,2465,2465,2465,2465,2465,2465,2465,2465,2465,2465,2465
2465,2465,2465,2465,2465,2465,2465,2465,2465,2465,2465,2465,2465,2465,2465,2465,2465,2465,2465,2465,2465,2465,2465,2465,2465,2465,2465,2465,2465,2465,2465,2465,2465,2465,2465,2465,2465,2465,2465,2465,2465,2465,2465,2465,2465,2465,2465,2465,2465,2465,2465,2465,2465,2465,2465,2465,2465,2465,2465,2465,2465,2465,2465,2465
2465,2465,2465,2465,2465,2465,2465,2465,2465,2465,2465,2465,2465,2465,2465,2465,2465,2465,2465,2465,2465,2465,2465,2465,2465,2465,2465,2465,2465,2465,2465,2465,2465,2465,2465,2465,2465,2465,2465,2465,2465,2465,2465,2465,2465,2465,2465,2465,2465,2465,2465,2465,2465,2465,2465,2465,2465,2465,2465,2465,2465,2465,2465,2465
2465,2465,2465,2465,2465,2465,2465,2465,2465,2465,2465,2465,2465,2465,2465,2465,2465,2465,2465,2465,2465,2465,2465,2465,2465,2465,2465,2465,2465,2465,2465,2465,2465,2465,2465,2465,2465,2465,2465,2465,2465,2465,2465,2465,2465,2465,2465,2465,2465,2465,2465,2465,2465,2465,2465,2465,2465,2465,2465,2465,2465,2465,2465,2465
2465,2465,2465,2465,2465,2465,2465,2465,2465,2465,2465,2465,2465,2465,2465,2465,2465,2465,2465,2465,2465,2465,2465,2465,2465,2465,2465,2465,2465,2465,2465,2465,2465,2465,2465,2465,2465,2465,2465,2465,2465,2465,2465,2465,2465,2465,2465,2465,2465,2465,2465,2465,2465,2465,2465,2465,2465,2465,2465,2465,2465,2465,2465,2465
