3209,3209,3209,3209,3209,3209,3209,3209,3209,3209,3209,3209,3209,3209,3209,3209,3209,3209,3209,3209,3209,3209,3209,3209,3209,3209,3209,3209,3209,3209,3209,3209,3209,3209,3209,3209,3209,3209,3209,3209,3209,3209,3209,3209,3209,3209,3209,3209,3209,3209,3209,3209,3209,3209,3209,3209,3209,3209,3209,3209,3209,3209,3209,3209
3209,3209,3209,3209,3209,3209,3209,3209,3209,3209,3209,3209,3209,3209,3209,3209,3209,3209,3209,3209,3209,3209,3209,3209,3209,3209,3209,3209,3209,3209,3209,3209,3209,3209,3209,3209,3209,3209,3209,3209,3209,3209,3209,3209,3209,3209,3209,3209,3209,3209,3209,3209,3209,3209,3209,3209,3209,3209,3209,3209,3209,3209,3209,3209
3209,3209,3209,3209,3209,3209,3209,3209,3209,3209,3209,3209,3209,3209,3209,3209,3209,3209,3209,3209,3209,3209,3209,3209,3209,3209,3209,3209,3209,3209,3209,3209,3209,3209,3209,3209,3209,3209,3209,3209,3209,3209,3209,3209,3209,3209,3209,3209,3209,3209,3209,3209,3209,3209,3209,3209,3209,3209,3209,3209,3209,3209,3209,3209
3209,3209,3209,3209,3209,3209,3209,3209,3209,3209,3209,3209,3209,3209,3209,3209,3209,3209,3209,3209,3209,3209,3209,3209,3209,3209,3209,3209,3209,3209,3209,3209,3209,3209,3209,3209,3209,3209,3209,3209,3209,3209,3209,3209,3209,3209,3209,3209,3209,3209,3209,3209,3209,3209,3209,3209,3209,3209,3209,3209,3209,3209,3209,3209
3209,3209,3209,3209,3209,3209,3209,3209,3209,3209,3209,2411,2411,2411,2411,2411,2411,2411,2411,2411,2411,2411,2411,2411,2411,2411,2411,2411,2411,2411,3209,3209,3209,3209,3209,3209,3209,3209,3209,3209,3209,3209,3209,3209,3209,3209,3209,3209,3209,3209,3209,3209,3209,3209,3209,3209,3209,3209,3209,3209,3209,3209,3209,3209
3209,3209,3209,3209,3209,2411,2411,2411,2411,2411,2411,2411,2411,2411,2411,2411,2411,2411,2411,2411,2411,2411,2411,2411,2411,2411,2411,2411,2411,2411,2411,2411,2411,2411,2411,2411,2411,2411,2411,2411,2411,2411,2411,2411,2411,2411,2411,2411,2411,2411,2411,2411,2411,2411,2411,2411,2411,2411,2411,2411,3209,3209,3209,3209
3209,3209,3209,3209,3209,2411,2411,2411,2411,2411,2411,2411,2411,2411,2411,2411,2411,2411,2411,2411,2411,2411,2411,2411,2411,2411,2411,2411,2411,2411,2411,2411,2411,2411,2411,2411,2411,2411,2411,2411,2411,2411,2411,2411,2411,2411,2411,2411,2411,2411,2411,2411,2411,2411,2411,2411,2411,2411,2411,2411,3209,3209,3209,3209
3209,3209,3209,3209,3209,2411,2411,2411,2411,2411,2411,2411,2411,2411,2411,2411,2411,2411,2411,2411,2411,2411,2411,2411,2411,2411,2411,2411,2411,2411,2411,2411,2411,2411,2411,2411,2411,2411,2411,2411,2411,2411,2411,2411,2411,2411,2411,2411,2411,2411,2411,2411,2411,2411,2411,2411,2411,2411,2411,2411,3209,3209,3209,3209
3209,3209,3209,3209,3209,2411,2411,2411,2411,2411,2411,2411,2411,2411,2411,2411,2411,2411,2411,2411,2411,2411,2411,2411,2411,2411,2411,2411,2411,2411,3209,3209,3209,3209,2411,2411,2411,2411,2411,3209,3209,3209,3209,3209,3209,3209,3209,3209,3209,3209,3209,3209,3209,3209,2411,2411,2411,2411,2411,2411,3209,3209,3209,3209
3209,3209,3209,3209,3209,2411,2411,2411,2411,2411,2411,2411,2411,3209,3209,3209,3209,3209,3209,3209,3209,3209,3209,3209,3209,3209,3209,3209,3209,3209,3209,3209,3209,3209,3209,3209,3209,3209,3209,3209,3209,3209,3209,3209,3209,3209,3209,3209,3209,3209,3209,3209,3209,3209,3209,2411,2411,2411,2411,2411,3209,3209,3209,3209
3209,3209,3209,3209,3209,2411,2411,2411,2411,2411,2411,2411,2411,2411,2411,2411,2411,2411,2411,2411,2411,2411,2411,2411,2411,2411,2411,2411,2411,2411,2411,2411,2411,2411,3209,3209,3209,3209,3209,3209,3209,3209,3209,3209,3209,3209,3209,3209,3209,3209,3209,3209,3209,3209,3209,2411,2411,2411,2411,2411,3209,3209,3209,3209
3209,3209,3209,3209,3209,2411,2411,2411,2411,2411,2411,2411,2411,2411,2411,2411,2411,2411,2411,2411,2411,2411,2411,2411,2411,2411,2411,2411,2411,2411,2411,2411,2411,2411,2411,3209,3209,3209,3209,3209,3209,3209,3209,3209,3209,3209,3209,3209,3209,3209,3209,3209,3209,3209,3209,2411,2411,2411,2411,2411,3209,3209,3209,3209
3209,3209,3209,3209,3209,2411,2411,2411,2411,2411,2411,2411,2411,2411,2411,2411,2411,2411,2411,2411,2411,2411,2411,2411,2411,2411,2411,2411,2411,2411,2411,2411,2411,2411,2411,3209,3209,3209,3209,3209,3209,3209,3209,3209,3209,3209,3209,3209,3209,3209,3209,3209,3209,3209,3209,2411,2411,2411,2411,2411,3209,3209,3209,3209
3209,3209,3209,3209,3209,2411,2411,2411,2411,2411,2411,2411,2411,2411,2411,2411,2411,2411,2411,2411,2411,2411,2411,2411,2411,2411,2411,2411,2411,2411,2411,2411,2411,2411,2411,2411,2411,2411,2411,2411,2411,2411,2411,2411,2411,2411,2411,2411,2411,2411,2411,2411,2411,2411,2411,2411,2411,2411,2411,2411,3209,3209,3209,3209
3209,3209,3209,3209,3209,2411,2411,2411,2411,2411,2411,2411,2411,2411,2411,2411,2411,2411,2411,2411,2411,2411,2411,2411,2411,2411,2411,2411,2411,2411,2411,2411,2411,2411,2411,2411,2411,2411,2411,2411,2411,2411,2411,2411,2411,2411,2411,2411,2411,2411,2411,2411,2411,2411,2411,2411,2411,2411,2411,2411,3209,3209,3209,3209
3209,3209,3209,3209,3209,2411,2411,2411,2411,2411,2411,2411,2411,2411,2411,2411,2411,2411,2411,2411,2411,2411,2411,2411,2411,2411,2411,2411,2411,2411,2411,2411,2411,2411,2411,2411,2411,2411,2411,2411,2411,2411,2411,2411,2411,2411,2411,2411,2411,2411,2411,2411,2411,2411,2411,2411,2411,2411,2411,2411,3209,3209,3209,3209
3209,3209,3209,3209,3209,2411,2411,2411,2411,2411,2411,2411,2411,2411,2411,2411,2411,2411,2411,2411,2411,2411,2411,2411,2411,2411,2411,2411,2411,2411,2411,2411,2411,2411,2411,2411,2411,2411,2411,2411,2411,2411,3209,3209,3209,3209,3209,3209,3209,3209,2411,2411,2411,2411,2411,2411,2411,2411,2411,2411,3209,3209,3209,3209
3209,3209,3209,3209,3209,2411,2411,2411,2411,3209,3209,3209,3209,3209,3209,3209,3209,3209,3209,3209,3209,3209,3209,3209,3209,3209,3209,3209,3209,3209,3209,3209,3209,3209,3209,3209,3209,3209,3209,2411,2411,2411,2411,2411,2411,2411,2411,2411,2411,2411,2411,2411,2411,2411,2411,2411,2411,2411,2411,2411,3209,3209,3209,3209
3209,3209,3209,3209,3209,2411,2411,2411,2411,2411,2411,2411,2411,2411,2411,2411,2411,2411,2411,2411,2411,2411,2411,2411,2411,2411,2411,2411,2411,2411,2411,2411,2411,2411,2411,2411,2411,2411,2411,2411,2411,2411,2411,2411,2411,2411,2411,2411,2411,2411,2411,2411,2411,2411,2411,2411,2411,2411,2411,2411,3209,3209,3209,3209
3209,3209,3209,3209,3209,2411,2411,2411,2411,2411,2411,2411,2411,2411,2411,2411,2411,2411,2411,2411,2411,2411,2411,2411,2411,2411,2411,2411,2411,2411,2411,2411,2411,2411,2411,2411,2411,2411,2411,2411,2411,2411,2411,2411,2411,2411,2411,2411,2411,2411,2411,2411,2411,2411,2411,2411,2411,2411,2411,2411,3209,3209,3209,3209
3209,3209,3209,3209,3209,2411,2411,2411,2411,2411,2411,2411,2411,2411,2411,2411,2411,2411,2411,2411,2411,2411,2411,2411,2411,2411,2411,2411,2411,2411,2411,2411,2411,2411,2411,2411,2411,2411,2411,2411,2411,2411,2411,2411,2411,2411,2411,2411,2411,2411,2411,2411,2411,2411,2411,2411,2411,2411,2411,2411,3209,3209,3209,3209
3209,3209,3209,3209,3209,2411,2411,2411,2411,2411,2411,2411,2411,2411,2411,2411,2411,2411,2411,2411,2411,2411,2411,2411,2411,2411,2411,2411,2411,2411,2411,2411,2411,2411,2411,2411,2411,2411,2411,2411,2411,2411,2411,2411,2411,2411,2411,2411,2411,2411,2411,2411,2411,2411,2411,2411,2411,2411,2411,2411,3209,3209,3209,3209
3209,3209,3209,3209,3209,2411,2411,2411,2411,2411,2411,2411,2411,2411,2411,2411,2411,2411,2411,2411,2411,2411,2411,2411,2411,2411,2411,2411,2411,2411,2411,2411,2411,2411,2411,2411,2411,2411,2411,2411,2411,2411,2411,2411,2411,2411,2411,2411,2411,2411,2411,2411,2411,2411,2411,2411,2411,2411,2411,2411,3209,3209,3209,3209
3209,3209,3209,3209,3209,2411,2411,2411,2411,2411,2411,2411,2411,2411,2411,2411,2411,2411,2411,2411,2411,2411,2411,2411,2411,2411,2411,2411,2411,2411,2411,2411,2411,2411,2411,2411,2411,2411,2411,2411,2411,2411,2411,2411,2411,2411,2411,2411,2411,2411,2411,2411,2411,2411,2411,2411,2411,2411,2411,2411,3209,3209,3209,3209
3209,3209,3209,3209,3209,2411,2411,2411,2411,2411,2411,2411,2411,2411,2411,2411,2411,2411,2411,2411,2411,2411,2411,2411,2411,2411,2411,2411,2411,2411,2411,2411,2411,2411,2411,2411,2411,2411,2411,2411,2411,2411,2411,2411,2411,2411,2411,2411,2411,2411,2411,2411,2411,2411,2411,2411,2411,2411,2411,2411,3209,3209,3209,3209
3209,3209,3209,3209,3209,2411,2411,2411,2411,2411,2411,2411,2411,2411,2411,2411,2411,2411,2411,2411,2411,2411,2411,2411,2411,2411,2411,2411,2411,2411,2411,2411,2411,2411,2411,2411,2411,2411,2411,2411,2411,2411,2411,2411,2411,2411,2411,2411,2411,2411,2411,2411,2411,2411,2411,2411,2411,2411,2411,2411,3209,3209,3209,3209
3209,3209,3209,3209,3209,2411,2411,2411,2411,2411,2411,2411,2411,2411,2411,2411,2411,2411,2411,2411,2411,2411,2411,2411,2411,2411,2411,2411,2411,2411,2411,2411,2411,2411,2411,2411,2411,2411,2411,2411,2411,2411,2411,2411,2411,2411,2411,2411,2411,2411,2411,2411,2411,2411,2411,2411,2411,2411,2411,2411,3209,3209,3209,3209
3209,3209,3209,3209,3209,2411,2411,2411,2411,2411,2411,2411,2411,2411,2411,2411,2411,2411,2411,2411,2411,2411,2411,2411,2411,2411,2411,2411,2411,2411,2411,2411,2411,2411,2411,2411,2411,2411,2411,2411,2411,2411,2411,2411,2411,2411,2411,2411,2411,2411,2411,2411,2411,2411,2411,2411,2411,2411,2411,2411,3209,3209,3209,3209
3209,3209,3209,3209,3209,2411,2411,2411,2411,2411,2411,2411,2411,2411,2411,2411,2411,2411,2411,2411,2411,2411,2411,2411,2411,2411,2411,2411,2411,2411,2411,2411,2411,2411,2411,2411,2411,2411,2411,2411,2411,2411,2411,2411,2411,2411,2411,2411,2411,2411,2411,2411,2411,2411,2411,2411,2411,2411,2411,2411,3209,3209,3209,3209
3209,3209,3209,3209,3209,2411,2411,2411,2411,2411,2411,2411,2411,2411,2411,2411,2411,2411,2411,2411,2411,2411,2411,2411,2411,2411,2411,2411,2411,2411,2411,2411,2411,2411,2411,2411,2411,2411,2411,2411,2411,2411,2411,2411,2411,2411,2411,2411,2411,2411,2411,2411,2411,2411,2411,2411,2411,2411,2411,2411,3209,3209,3209,3209
3209,3209,3209,3209,3209,2411,2411,2411,2411,2411,2411,2411,2411,2411,2411,2411,2411,2411,2411,2411,2411,2411,2411,2411,2411,2411,2411,2411,2411,2411,2411,2411,2411,2411,2411,2411,2411,2411,2411,2411,2411,2411,2411,2411,2411,2411,2411,2411,2411,2411,2411,2411,2411,2411,2411,2411,2411,2411,2411,2411,3209,3209,3209,3209
3209,3209,3209,3209,3209,2411,2411,2411,2411,2411,2411,2411,2411,2411,2411,2411,2411,2411,2411,2411,2411,2411,2411,2411,2411,2411,2411,2411,2411,2411,2411,2411,2411,2411,2411,2411,2411,2411,2411,2411,2411,2411,2411,2411,2411,2411,2411,2411,2411,2411,2411,2411,2411,2411,2411,2411,2411,2411,2411,2411,3209,3209,3209,3209
3209,3209,3209,3209,3209,2411,2411,2411,2411,2411,2411,2411,2411,2411,2411,2411,2411,2411,2411,2411,2411,2411,2411,2411,2411,2411,2411,2411,2411,2411,2411,2411,2411,2411,2411,2411,2411,2411,2411,2411,2411,2411,2411,2411,2411,2411,2411,2411,2411,2411,2411,2411,2411,2411,2411,2411,2411,2411,2411,2411,3209,3209,3209,3209
3209,3209,3209,3209,3209,2411,2411,2411,2411,2411,2411,2411,2411,2411,2411,2411,2411,2411,2411,2411,2411,2411,2411,2411,2411,2411,2411,2411,2411,2411,2411,2411,2411,2411,2411,2411,2411,2411,2411,2411,2411,2411,2411,2411,2411,2411,2411,2411,2411,2411,2411,2411,2411,2411,2411,2411,2411,2411,2411,2411,3209,3209,3209,3209
3209,3209,3209,3209,3209,2411,2411,2411,2411,2411,2411,2411,2411,2411,2411,2411,2411,2411,2411,2411,2411,2411,2411,2411,2411,2411,2411,2411,2411,2411,2411,2411,2411,2411,2411,2411,2411,2411,2411,2411,2411,2411,2411,2411,2411,2411,2411,2411,2411,2411,3209,2411,2411,2411,2411,2411,2411,2411,2411,2411,3209,3209,3209,3209
3209,3209,3209,3209,3209,2411,2411,2411,2411,2411,2411,2411,2411,2411,2411,2411,2411,2411,2411,2411,2411,2411,2411,2411,2411,2411,2411,2411,2411,2411,2411,2411,2411,2411,2411,2411,2411,2411,2411,2411,2411,2411,2411,2411,2411,2411,2411,2411,2411,2411,3209,2411,2411,2411,2411,2411,2411,2411,2411,2411,3209,3209,3209,3209
3209,3209,3209,3209,3209,2411,2411,2411,2411,2411,2411,2411,2411,2411,2411,2411,2411,2411,2411,2411,2411,2411,2411,2411,2411,2411,2411,2411,2411,2411,2411,2411,2411,2411,2411,2411,2411,2411,2411,2411,2411,2411,2411,2411,2411,2411,2411,2411,2411,2411,3209,2411,2411,2411,2411,2411,2411,2411,2411,2411,3209,3209,3209,3209
3209,3209,3209,3209,3209,2411,2411,2411,2411,2411,2411,2411,2411,2411,2411,2411,2411,2411,2411,2411,2411,2411,2411,2411,2411,2411,2411,2411,2411,2411,2411,2411,2411,2411,2411,2411,2411,2411,2411,2411,2411,2411,2411,2411,2411,2411,2411,2411,2411,2411,3209,2411,2411,2411,2411,2411,2411,2411,2411,2411,3209,3209,3209,3209
3209,3209,3209,3209,3209,2411,2411,2411,2411,2411,2411,2411,2411,2411,2411,2411,2411,2411,2411,2411,2411,2411,2411,2411,2411,2411,2411,2411,2411,2411,2411,2411,2411,2411,2411,2411,2411,2411,2411,2411,2411,2411,2411,2411,2411,2411,2411,2411,2411,2411,3209,3209,2411,2411,2411,2411,2411,2411,2411,2411,3209,3209,3209,3209
3209,3209,3209,3209,3209,2411,2411,2411,2411,2411,2411,2411,2411,2411,2411,2411,2411,2411,2411,2411,2411,2411,2411,2411,2411,2411,2411,2411,2411,2411,2411,2411,2411,2411,2411,2411,2411,2411,2411,2411,2411,2411,2411,2411,2411,2411,2411,2411,2411,2411,2411,3209,2411,2411,2411,2411,2411,2411,2411,2411,3209,3209,3209,3209
3209,3209,3209,3209,3209,2411,2411,2411,2411,2411,2411,2411,2411,2411,2411,2411,2411,2411,2411,2411,2411,2411,2411,2411,2411,2411,2411,2411,2411,2411,2411,2411,2411,2411,2411,2411,2411,2411,2411,2411,2411,2411,2411,2411,2411,2411,2411,2411,2411,2411,3209,3209,2411,2411,2411,2411,2411,2411,2411,2411,3209,3209,3209,3209
3209,3209,3209,3209,3209,2411,2411,2411,2411,2411,2411,2411,2411,2411,2411,2411,2411,2411,2411,2411,2411,2411,2411,2411,2411,2411,2411,2411,2411,2411,2411,2411,2411,2411,2411,2411,2411,2411,2411,2411,2411,2411,2411,2411,2411,2411,2411,2411,2411,2411,3209,3209,2411,2411,2411,2411,2411,2411,2411,2411,3209,3209,3209,3209
3209,3209,3209,3209,3209,2411,2411,2411,2411,2411,2411,2411,2411,2411,2411,2411,2411,2411,2411,2411,2411,2411,2411,2411,2411,2411,2411,2411,2411,2411,2411,2411,2411,2411,2411,2411,2411,2411,2411,2411,2411,2411,2411,2411,2411,2411,2411,2411,2411,2411,3209,3209,2411,2411,2411,2411,2411,2411,2411,2411,3209,3209,3209,3209
3209,3209,3209,3209,3209,2411,2411,2411,2411,2411,2411,2411,2411,2411,2411,2411,2411,2411,2411,2411,2411,2411,2411,2411,2411,2411,2411,2411,2411,2411,2411,2411,2411,2411,2411,2411,2411,2411,2411,2411,2411,2411,2411,2411,2411,3209,3209,3209,3209,3209,3209,3209,2411,2411,2411,2411,2411,2411,2411,2411,3209,3209,3209,3209
3209,3209,3209,3209,3209,2411,2411,2411,2411,2411,2411,2411,2411,2411,2411,2411,2411,2411,2411,2411,2411,2411,2411,2411,2411,2411,2411,3209,3209,3209,3209,3209,3209,3209,3209,3209,3209,3209,2411,2411,2411,2411,2411,2411,2411,2411,2411,3209,3209,3209,3209,3209,2411,2411,2411,2411,2411,2411,2411,2411,3209,3209,3209,3209
3209,3209,3209,3209,3209,2411,2411,2411,2411,2411,2411,3209,3209,3209,3209,3209,3209,3209,3209,3209,3209,3209,3209,3209,3209,3209,3209,3209,3209,3209,3209,3209,3209,3209,3209,3209,3209,3209,2411,2411,2411,2411,2411,2411,2411,2411,2411,2411,2411,2411,2411,2411,2411,2411,2411,2411,2411,2411,2411,2411,3209,3209,3209,3209
3209,3209,3209,3209,3209,2411,2411,2411,2411,2411,2411,2411,2411,2411,2411,2411,2411,2411,2411,2411,2411,2411,2411,2411,2411,2411,2411,2411,2411,2411,2411,2411,2411,2411,2411,2411,2411,2411,2411,2411,2411,2411,2411,2411,2411,2411,2411,2411,2411,2411,2411,2411,2411,2411,2411,2411,2411,2411,2411,2411,3209,3209,3209,3209
3209,3209,3209,3209,3209,2411,2411,2411,2411,2411,2411,2411,2411,2411,2411,2411,2411,2411,2411,2411,2411,2411,2411,2411,2411,2411,2411,2411,2411,2411,2411,2411,2411,2411,2411,2411,2411,2411,2411,2411,2411,2411,2411,2411,2411,2411,2411,2411,2411,2411,2411,2411,2411,2411,2411,2411,2411,2411,2411,2411,3209,3209,3209,3209
3209,3209,3209,3209,3209,2411,2411,2411,2411,2411,2411,2411,2411,2411,2411,2411,2411,2411,2411,2411,2411,2411,2411,2411,2411,2411,2411,2411,2411,2411,2411,2411,2411,2411,2411,2411,2411,2411,2411,2411,2411,2411,2411,2411,2411,2411,2411,2411,2411,2411,2411,2411,2411,2411,2411,2411,2411,2411,2411,2411,3209,3209,3209,3209
3209,3209,3209,3209,3209,2411,2411,2411,2411,2411,2411,2411,2411,2411,2411,2411,2411,2411,2411,2411,2411,2411,2411,2411,2411,2411,2411,2411,2411,2411,2411,2411,2411,2411,2411,2411,2411,2411,2411,2411,2411,2411,2411,2411,2411,2411,2411,2411,2411,2411,2411,2411,2411,2411,2411,2411,2411,2411,2411,2411,3209,3209,3209,3209
3209,3209,3209,3209,3209,2411,2411,2411,2411,2411,2411,2411,2411,2411,2411,2411,2411,2411,2411,2411,2411,2411,2411,2411,2411,3209,3209,3209,3209,3209,3209,3209,3209,3209,3209,3209,3209,3209,2411,2411,2411,2411,2411,2411,2411,2411,2411,2411,2411,2411,2411,2411,2411,2411,2411,2411,2411,2411,2411,2411,3209,3209,3209,3209
3209,3209,3209,3209,3209,2411,2411,2411,2411,2411,2411,2411,2411,2411,2411,2411,2411,2411,2411,2411,2411,2411,2411,2411,2411,3209,3209,3209,3209,3209,3209,3209,3209,3209,3209,3209,3209,3209,2411,2411,2411,2411,2411,2411,2411,2411,2411,2411,2411,2411,2411,2411,2411,2411,2411,2411,2411,2411,2411,2411,3209,3209,3209,3209
3209,3209,3209,3209,3209,2411,2411,2411,2411,2411,2411,2411,2411,2411,2411,2411,2411,2411,2411,2411,2411,2411,2411,2411,2411,3209,3209,3209,3209,3209,3209,3209,3209,3209,3209,3209,3209,3209,3209,3209,3209,3209,3209,3209,3209,3209,2411,2411,2411,2411,2411,2411,2411,2411,2411,3209,3209,3209,3209,2411,3209,3209,3209,3209
3209,3209,3209,3209,3209,2411,2411,2411,2411,2411,2411,2411,2411,2411,2411,2411,2411,2411,2411,2411,3209,3209,2411,2411,3209,3209,3209,3209,3209,3209,3209,3209,3209,3209,3209,3209,3209,3209,3209,3209,3209,3209,3209,3209,3209,3209,3209,3209,3209,3209,3209,3209,3209,3209,3209,3209,3209,3209,3209,2411,3209,3209,3209,3209
3209,3209,3209,3209,3209,3209,3209,3209,3209,3209,3209,2411,2411,2411,3209,3209,3209,3209,3209,3209,3209,3209,3209,3209,3209,3209,3209,3209,3209,3209,3209,3209,3209,3209,3209,3209,3209,3209,3209,3209,3209,3209,3209,3209,3209,3209,3209,3209,3209,3209,3209,3209,3209,3209,3209,3209,3209,3209,3209,2411,3209,3209,3209,3209
3209,3209,3209,3209,3209,2411,2411,2411,2411,2411,2411,2411,2411,2411,2411,2411,2411,2411,2411,2411,2411,2411,2411,2411,2411,2411,2411,3209,3209,3209,3209,3209,3209,3209,3209,3209,3209,3209,3209,3209,3209,3209,3209,3209,3209,3209,3209,3209,3209,3209,3209,3209,3209,3209,3209,3209,3209,3209,3209,2411,3209,3209,3209,3209
3209,3209,3209,3209,3209,2411,2411,2411,2411,2411,2411,2411,2411,2411,2411,2411,2411,2411,2411,2411,2411,2411,2411,2411,2411,2411,2411,2411,2411,2411,2411,3209,3209,3209,3209,3209,3209,3209,3209,3209,3209,3209,3209,3209,3209,3209,3209,3209,3209,3209,3209,3209,3209,3209,3209,3209,3209,3209,3209,2411,3209,3209,3209,3209
3209,3209,3209,3209,3209,2411,2411,2411,2411,2411,2411,2411,2411,2411,2411,2411,2411,2411,2411,2411,2411,2411,2411,2411,2411,2411,2411,2411,2411,2411,2411,2411,2411,2411,2411,2411,2411,2411,2411,2411,2411,2411,2411,2411,2411,2411,2411,2411,2411,2411,2411,2411,2411,2411,2411,2411,2411,2411,2411,2411,2411,3209,3209,3209
3209,3209,3209,3209,3209,2411,2411,2411,2411,2411,2411,2411,2411,2411,2411,2411,2411,2411,2411,2411,2411,2411,2411,2411,2411,2411,2411,2411,2411,2411,2411,2411,2411,2411,2411,2411,2411,2411,2411,2411,2411,2411,2411,2411,2411,2411,2411,2411,2411,2411,2411,2411,2411,2411,2411,2411,2411,2411,2411,2411,2411,3209,3209,3209
3209,3209,3209,3209,3209,2411,2411,2411,2411,2411,2411,2411,2411,2411,2411,2411,2411,2411,2411,2411,2411,2411,2411,2411,2411,2411,2411,2411,2411,2411,2411,2411,2411,2411,2411,2411,2411,2411,2411,2411,2411,2411,2411,2411,2411,2411,2411,2411,2411,2411,2411,2411,2411,2411,2411,2411,2411,2411,2411,2411,2411,3209,3209,3209
3209,3209,3209,3209,3209,3209,3209,3209,3209,3209,3209,3209,3209,3209,3209,3209,3209,3209,3209,3209,3209,3209,3209,3209,3209,3209,3209,3209,3209,3209,3209,3209,3209,3209,3209,3209,3209,3209,3209,3209,3209,3209,3209,3209,3209,3209,3209,3209,3209,3209,3209,3209,3209,3209,3209,3209,3209,3209,3209,2411,3209,3209,3209,3209
3209,3209,3209,3209,3209,3209,3209,3209,3209,3209,3209,3209,3209,3209,3209,3209,3209,3209,3209,3209,3209,3209,3209,3209,3209,3209,3209,3209,3209,3209,3209,3209,3209,3209,3209,3209,3209,3209,3209,3209,3209,3209,3209,3209,3209,3209,3209,3209,3209,3209,3209,3209,3209,3209,3209,3209,3209,3209,3209,2411,3209,3209,3209,3209
3209,3209,3209,3209,3209,3209,3209,3209,3209,3209,3209,3209,3209,3209,3209,3209,3209,3209,3209,3209,3209,3209,3209,3209,3209,3209,3209,3209,3209,3209,3209,3209,3209,3209,3209,3209,3209,3209,3209,3209,3209,3209,3209,3209,3209,3209,3209,3209,3209,3209,3209,3209,3209,3209,3209,3209,3209,3209,3209,3209,3209,3209,3209,3209
3209,3209,3209,3209,3209,3209,3209,3209,3209,3209,3209,3209,3209,3209,3209,3209,3209,3209,3209,3209,3209,3209,3209,3209,3209,3209,3209,3209,3209,3209,3209,3209,3209,3209,3209,3209,3209,3209,3209,3209,3209,3209,3209,3209,3209,3209,3209,3209,3209,3209,3209,3209,3209,3209,3209,3209,3209,3209,3209,3209,3209,3209,3209,3209
